00,00,00,00,00,00,00,00,00,00,00,00,00,00,00,00,00,00,00,07,09,11,00,00,00,00,00,00,00,00,00,00,00,00,00,00,07,09,09,11,00,00,00,00,00,00,00,00,00,00,00,00,00,00,00,00,00,00,00,00,00,00,00,00,00,00,00,07,09,11,00,00,00,00,00,00,00,00,00,00,00,00,00,00,07,09,09,11,00,00,00,00,00,00,00,00,00,00,00,00,00,00,00,00,00,00,00,00,00,00,00,00,00,00,00,07,09,11,00,00,00,00,00,00,00,00,00,00,00,00,00,00,07,09,09,11,00,00,00,00,00,00,00,00,00,00,00,00,00,00,00,00,00,00,00,00,00,00,00,00,00,00,00,07,09,11,00,00,00,00,00,00,00,00,00,00,00,00,00,00,07,09,09,11,00,00,00,00,00,00,00,00,00,00,00,00,00,00,24,00,00,00,00,00,00,00,00,00,00,00,00,00,
00,00,00,00,00,00,00,00,08,10,12,00,00,00,00,00,00,00,00,08,10,12,00,00,00,00,00,07,09,09,09,11,00,00,00,00,08,10,10,12,00,00,00,00,00,00,00,00,00,00,00,00,00,00,00,00,07,09,11,00,00,00,00,00,00,00,00,08,10,12,00,00,00,00,00,07,09,09,09,11,00,00,00,00,08,10,10,12,00,00,00,00,00,00,00,00,00,00,00,00,00,00,00,00,07,09,11,00,00,00,00,00,00,00,00,08,10,12,00,00,00,00,00,07,09,09,09,11,00,00,00,00,08,10,10,12,00,00,00,00,00,00,00,00,00,00,00,00,00,00,00,00,07,09,11,00,00,00,00,00,00,00,00,08,10,12,00,00,00,00,00,07,09,09,09,11,00,00,00,00,08,10,10,12,00,00,00,00,00,00,00,00,00,00,00,00,00,00,25,00,07,09,11,00,00,00,00,00,00,00,00,00,
00,00,00,00,00,00,00,00,09,11,13,00,00,00,00,00,00,00,00,00,00,00,00,00,00,00,00,08,10,10,10,12,00,00,00,00,00,00,00,00,00,00,00,00,00,00,00,00,00,00,00,00,00,00,00,00,08,10,12,00,00,00,00,00,00,00,00,00,00,00,00,00,00,00,00,08,10,10,10,12,00,00,00,00,00,00,00,00,00,00,00,00,00,00,00,00,00,00,00,00,00,00,00,00,08,10,12,00,00,00,00,00,00,00,00,00,00,00,00,00,00,00,00,08,10,10,10,12,00,00,00,00,00,00,00,00,00,00,00,00,00,00,00,00,00,00,00,00,00,00,00,00,08,10,12,00,00,00,00,00,00,00,00,00,00,00,00,00,00,00,00,08,10,10,10,12,00,00,00,00,00,00,00,00,00,00,00,00,00,00,00,00,00,00,00,00,00,00,24,00,08,10,12,00,00,00,00,00,00,00,00,00,
00,00,00,00,00,00,00,00,00,00,00,00,00,00,00,00,00,00,00,00,00,00,16,00,00,00,00,00,00,00,00,00,00,00,00,00,00,00,00,00,00,00,00,00,00,00,00,00,00,00,00,00,00,00,00,00,00,00,00,00,00,00,00,00,00,00,00,00,00,00,00,00,00,00,00,00,00,00,00,00,17,17,17,17,17,17,17,17,00,00,00,17,17,17,16,00,00,00,00,00,00,00,00,00,00,00,00,00,00,16,00,00,00,00,00,00,00,00,00,00,00,17,17,17,00,00,00,00,17,16,16,17,00,00,00,00,00,00,00,00,00,00,00,00,00,00,00,00,00,00,00,00,00,00,00,00,00,00,00,00,00,00,00,00,00,00,00,00,00,00,00,00,00,00,00,00,00,00,00,00,00,00,00,00,00,00,00,00,22,22,00,00,00,00,00,00,00,00,24,00,00,00,00,00,00,00,00,00,00,00,00,00,
00,00,00,00,00,00,00,00,00,00,00,00,00,00,00,00,00,00,00,00,00,00,00,00,00,00,00,00,00,00,00,00,00,00,00,00,00,00,00,00,00,00,00,00,00,00,00,00,00,00,00,00,00,00,00,00,00,00,00,00,00,00,00,00,00,00,00,00,00,00,00,00,00,00,00,00,00,00,00,00,00,00,00,00,00,00,00,00,00,00,00,00,00,00,00,00,00,00,00,00,00,00,00,00,00,00,00,00,00,00,00,00,00,00,00,00,00,00,00,00,00,00,00,00,00,00,00,00,00,00,00,00,00,00,00,00,00,00,00,00,00,00,00,00,00,00,00,00,00,00,00,00,00,00,00,00,00,00,00,00,00,00,00,00,00,00,00,00,00,00,00,00,00,00,00,00,00,00,00,00,00,00,00,00,00,00,00,22,22,22,00,00,00,00,00,00,00,00,24,00,00,00,00,00,00,00,00,00,00,00,00,00,
00,00,00,00,00,00,00,00,00,00,00,00,00,00,00,00,00,00,00,00,00,00,00,00,00,00,00,00,00,00,00,00,00,00,00,00,00,00,00,00,00,00,00,00,00,00,00,00,00,00,00,00,00,00,00,00,00,00,00,00,00,00,00,00,00,00,00,00,00,00,00,00,00,00,00,00,00,00,00,00,00,00,00,00,00,00,00,00,00,00,00,00,00,00,00,00,00,00,00,00,00,00,00,00,00,00,00,00,00,00,00,00,00,00,00,00,00,00,00,00,00,00,00,00,00,00,00,00,00,00,00,00,00,00,00,00,00,00,00,00,00,00,00,00,00,00,00,00,00,00,00,00,00,00,00,00,00,00,00,00,00,00,00,00,00,00,00,00,00,00,00,00,00,00,00,00,00,00,00,00,00,00,00,00,00,00,22,22,22,22,00,00,00,00,00,00,00,00,24,00,00,00,00,00,00,00,00,00,00,00,00,00,
00,00,00,00,00,00,00,00,00,00,00,00,00,00,00,00,00,00,00,00,00,00,00,00,00,00,00,00,00,00,00,00,00,00,00,00,00,00,00,00,00,00,00,00,00,00,00,00,00,00,00,00,00,00,00,00,00,00,00,00,00,00,00,00,00,00,00,00,00,00,00,00,00,00,00,00,00,00,00,00,00,00,00,00,00,00,00,00,00,00,00,00,00,00,00,00,00,00,00,00,00,00,00,00,00,00,00,00,00,00,00,00,00,00,00,00,00,00,00,00,00,00,00,00,00,00,00,00,00,00,00,00,00,00,00,00,00,00,00,00,00,00,00,00,00,00,00,00,00,00,00,00,00,00,00,00,00,00,00,00,00,00,00,00,00,00,00,00,00,00,00,00,00,00,00,00,00,00,00,00,00,00,00,00,00,22,22,22,22,22,00,00,00,00,00,00,00,00,24,00,00,00,00,25,25,25,00,00,00,00,00,00,
00,00,00,00,00,00,00,00,00,00,00,00,00,00,00,00,17,00,00,00,18,16,17,16,17,00,00,00,00,00,00,00,00,00,00,00,00,00,00,00,00,00,00,00,00,00,18,20,00,00,00,00,00,00,00,00,00,18,20,00,00,00,00,00,00,00,00,00,00,00,00,00,00,00,00,00,00,17,16,17,00,00,00,00,00,00,00,00,00,00,00,00,00,00,17,00,00,00,00,00,17,00,00,00,00,00,16,00,00,16,00,00,16,00,00,00,00,00,17,00,00,00,00,00,00,00,00,00,00,17,17,00,00,00,00,00,00,22,00,00,22,00,00,00,00,00,00,00,00,00,00,22,22,00,00,22,00,00,00,00,00,00,00,00,00,00,00,00,17,17,16,17,00,00,00,00,00,00,00,00,00,00,00,00,22,22,22,22,22,22,00,00,00,00,00,00,00,00,24,00,00,00,00,28,26,32,00,00,00,00,00,00,
00,00,05,00,00,00,00,00,00,00,00,00,00,00,00,00,00,00,00,00,00,00,00,00,00,00,00,00,00,00,00,00,00,00,00,00,00,00,18,20,00,00,00,00,00,00,19,21,00,00,04,00,00,00,00,00,00,19,21,00,00,00,00,00,00,00,00,00,00,00,00,00,00,00,00,00,00,00,00,00,00,00,00,00,00,00,00,00,00,00,00,00,00,00,00,00,00,00,04,00,00,00,00,00,00,00,00,00,00,00,00,00,00,00,00,00,00,00,00,00,00,00,00,00,00,00,00,00,00,00,00,00,00,00,00,00,22,22,00,00,22,22,00,00,00,00,04,00,00,00,22,22,22,00,00,22,22,00,00,00,00,00,00,00,00,00,00,00,00,00,00,00,00,00,00,00,00,00,00,00,00,00,00,22,22,22,22,22,22,22,00,00,00,00,04,00,00,00,24,00,00,00,26,29,28,28,25,00,00,00,00,00,
00,02,02,07,00,00,00,00,00,00,00,00,00,00,00,00,00,04,00,00,00,00,00,00,00,00,00,00,19,21,00,00,00,00,00,00,00,00,19,21,00,00,00,00,00,00,19,21,00,01,02,06,00,00,00,00,00,19,21,00,00,00,00,00,00,04,00,00,00,00,00,00,00,00,00,00,00,00,00,00,00,00,00,00,00,00,00,00,00,00,00,00,00,00,00,00,00,01,02,06,00,00,00,00,00,00,00,00,00,00,00,00,00,04,00,00,00,00,00,00,00,00,00,00,00,00,00,00,00,00,00,00,00,00,00,22,22,22,00,00,22,22,22,00,00,01,02,06,00,22,22,22,22,00,00,22,22,22,00,00,00,04,00,18,20,00,00,00,00,00,00,00,00,00,00,00,00,00,00,18,20,00,22,22,22,22,22,22,22,22,00,00,00,01,02,06,00,00,24,00,00,00,27,26,30,26,26,00,00,04,00,00,
00,03,06,02,06,00,00,00,00,00,00,14,15,14,14,16,01,02,06,00,00,00,00,13,14,15,00,00,20,22,00,00,00,00,00,00,00,00,19,21,00,13,14,14,15,00,19,21,01,02,05,02,06,00,00,00,00,19,21,13,14,14,14,15,01,02,06,00,00,00,00,13,14,15,00,00,00,00,00,00,00,00,00,00,00,00,00,00,00,13,14,14,15,00,00,00,01,02,05,02,06,00,00,00,00,00,00,13,14,14,14,15,01,02,06,00,00,00,00,13,14,15,00,00,00,00,00,00,00,00,00,00,00,00,23,22,22,22,14,14,22,22,22,22,01,02,05,02,22,22,22,22,22,00,00,22,22,22,22,15,01,02,06,19,21,00,00,13,14,15,00,00,00,00,00,00,00,00,00,19,21,22,22,22,22,22,22,22,22,22,00,00,01,02,05,02,06,00,22,00,00,00,26,26,31,26,26,15,01,02,06,00,
00,04,03,03,03,03,03,03,03,03,03,03,03,03,03,03,03,03,03,03,03,03,03,03,03,03,03,03,03,03,03,03,03,03,03,03,03,03,03,03,03,03,03,03,03,03,03,03,03,03,03,03,03,03,03,03,03,03,03,03,03,03,03,03,03,03,03,03,03,00,00,03,03,03,03,03,03,03,03,03,03,03,03,03,03,03,00,00,00,03,03,03,03,03,03,03,03,03,03,03,03,03,03,03,03,03,03,03,03,03,03,03,03,03,03,03,03,03,03,03,03,03,03,03,03,03,03,03,03,03,03,03,03,03,03,03,03,03,03,03,03,03,03,03,03,03,03,03,03,03,03,03,03,00,00,03,03,03,03,03,03,03,03,03,03,03,03,03,03,03,03,03,03,03,03,03,03,03,03,03,03,03,03,03,03,03,03,03,03,03,03,03,03,03,03,03,03,03,03,03,03,03,03,03,03,03,03,03,03,03,03,03,
00,03,03,03,03,03,03,03,03,03,03,03,03,03,03,03,03,03,03,03,03,03,03,03,03,03,03,03,03,03,03,03,03,03,03,03,03,03,03,03,03,03,03,03,03,03,03,03,03,03,03,03,03,03,03,03,03,03,03,03,03,03,03,03,03,03,03,03,03,00,00,03,03,03,03,03,03,03,03,03,03,03,03,03,03,03,00,00,00,03,03,03,03,03,03,03,03,03,03,03,03,03,03,03,03,03,03,03,03,03,03,03,03,03,03,03,03,03,03,03,03,03,03,03,03,03,03,03,03,03,03,03,03,03,03,03,03,03,03,03,03,03,03,03,03,03,03,03,03,03,03,03,03,00,00,03,03,03,03,03,03,03,03,03,03,03,03,03,03,03,03,03,03,03,03,03,03,03,03,03,03,03,03,03,03,03,03,03,03,03,03,03,03,03,03,03,03,03,03,03,03,03,03,03,03,03,03,03,03,03,03,03,
